ALBANIA	AL	
ALGERIA	DZ	
ANDORRA	AD	
ANGOLA	AO	
ANGUILLA	AI	
ANTIGUA & BARBUDA	AG	
ARGENTINA	AR	Required
ARMENIA	AM	
ARUBA	AW	
AUSTRALIA	AU	Required
AUSTRIA	AT	Required
AZERBAIJAN	AZ	
BAHAMAS	BS	
BAHRAIN	BH	
BARBADOS	BB	
BELARUS	BY	
BELGIUM	BE	
BELIZE	BZ	
BENIN	BJ	
BERMUDA	BM	
BHUTAN	BT	Required
BOLIVIA	BO	
BOSNIA & HERZEGOVINA	BA	
BOTSWANA	BW	
BRAZIL	BR	Required
BRITISH VIRGIN ISLANDS	VG	
BRUNEI	BN	
BULGARIA	BG	
BURKINA FASO	BF	
BURUNDI	BI	
CAMBODIA	KH	
CAMEROON	CM	
CANADA	CA	Required
CAPE VERDE	CV	
CAYMAN ISLANDS	KY	
CHAD	TD	
CHILE	CL	
CHINA	C2	Required
COLOMBIA	CO	
COMOROS	KM	Required
CONGO - BRAZZAVILLE	CG	
CONGO - KINSHASA	CD	
COOK ISLANDS	CK	
COSTA RICA	CR	
CÔTE D’IVOIRE	CI	
CROATIA	HR	
CYPRUS	CY	
CZECH REPUBLIC	CZ	
DENMARK	DK	Required
DJIBOUTI	DJ	
DOMINICA	DM	
DOMINICAN REPUBLIC	DO	
ECUADOR	EC	
EGYPT	EG	
EL SALVADOR	SV	
ERITREA	ER	
ESTONIA	EE	
ETHIOPIA	ET	
FALKLAND ISLANDS	FK	Required
FAROE ISLANDS	FO	Required
FIJI	FJ	
FINLAND	FI	
FRANCE	FR	Required
FRENCH GUIANA	GF	
FRENCH POLYNESIA	PF	
GABON	GA	
GAMBIA	GM	Required
GEORGIA	GE	
GERMANY	DE	Required
GIBRALTAR	GI	
GREECE	GR	
GREENLAND	GL	Required
GRENADA	GD	
GUADELOUPE	GP	
GUATEMALA	GT	
GUINEA	GN	
GUINEA-BISSAU	GW	
GUYANA	GY	
HONDURAS	HN	
HONG KONG SAR CHINA	HK	
HUNGARY	HU	
ICELAND	IS	
INDIA	IN	
INDONESIA	ID	
IRELAND	IE	
ISRAEL	IL	
ITALY	IT	Required
JAMAICA	JM	
JAPAN	JP	Required
JORDAN	JO	
KAZAKHSTAN	KZ	
KENYA	KE	
KIRIBATI	KI	Required
KUWAIT	KW	
KYRGYZSTAN	KG	Required
LAOS	LA	
LATVIA	LV	
LESOTHO	LS	
LIECHTENSTEIN	LI	
LITHUANIA	LT	
LUXEMBOURG	LU	
MACEDONIA	MK	
MADAGASCAR	MG	
MALAWI	MW	Required
MALAYSIA	MY	
MALDIVES	MV	
MALI	ML	
MALTA	MT	
MARSHALL ISLANDS	MH	
MARTINIQUE	MQ	
MAURITANIA	MR	Required
MAURITIUS	MU	
MAYOTTE	YT	Required
MEXICO	MX	Required
MICRONESIA	FM	
MOLDOVA	MD	
MONACO	MC	
MONGOLIA	MN	
MONTENEGRO	ME	
MONTSERRAT	MS	
MOROCCO	MA	
MOZAMBIQUE	MZ	
NAMIBIA	NA	
NAURU	NR	Required
NEPAL	NP	
NETHERLANDS	NL	Required
NEW CALEDONIA	NC	
NEW ZEALAND	NZ	
NICARAGUA	NI	
NIGER	NE	Required
NIGERIA	NG	
NIUE	NU	Required
NORFOLK ISLAND	NF	Required
NORWAY	NO	Required
OMAN	OM	
PALAU	PW	
PANAMA	PA	
PAPUA NEW GUINEA	PG	
PARAGUAY	PY	
PERU	PE	
PHILIPPINES	PH	
PITCAIRN ISLANDS	PN	Required
POLAND	PL	Required
PORTUGAL	PT	
QATAR	QA	
RÉUNION	RE	
ROMANIA	RO	
RUSSIA	RU	Required
RWANDA	RW	
SAMOA	WS	
SAN MARINO	SM	
SÃO TOMÉ & PRÍNCIPE	ST	
SAUDI ARABIA	SA	
SENEGAL	SN	
SERBIA	RS	
SEYCHELLES	SC	
SIERRA LEONE	SL	
SINGAPORE	SG	Required
SLOVAKIA	SK	
SLOVENIA	SI	
SOLOMON ISLANDS	SB	
SOMALIA	SO	
SOUTH AFRICA	ZA	
SOUTH KOREA	KR	
SPAIN	ES	Required
SRI LANKA	LK	
ST. HELENA	SH	Required
ST. KITTS & NEVIS	KN	
ST. LUCIA	LC	
ST. PIERRE & MIQUELON	PM	Required
ST. VINCENT & GRENADINES	VC	
SURINAME	SR	Required
SVALBARD & JAN MAYEN	SJ	Required
SWAZILAND	SZ	
SWEDEN	SE	Required
SWITZERLAND	CH	Required
TAIWAN	TW	
TAJIKISTAN	TJ	
TANZANIA	TZ	
THAILAND	TH	
TOGO	TG	
TONGA	TO	
TRINIDAD & TOBAGO	TT	
TUNISIA	TN	
TURKMENISTAN	TM	
TURKS & CAICOS ISLANDS	TC	
TUVALU	TV	Required
UGANDA	UG	
UKRAINE	UA	
UNITED ARAB EMIRATES	AE	
UNITED KINGDOM	GB	Required
UNITED STATES	US	Required
URUGUAY	UY	
VANUATU	VU	
VATICAN CITY	VA	Required
VENEZUELA	VE	
VIETNAM	VN	
WALLIS & FUTUNA	WF	Required
YEMEN	YE	
ZAMBIA	ZM	
ZIMBABWE	ZW	
